BUILDING	B IH L D IH NG
DITCH	D IH CH
FARMLAND	F AA R M L AE N D
FLAT	F L AE T
FOOTWAY	F UH T W EY
FOREST	F AO R AH S T
FOREST(2)	F AO R IH S T
GABLED	G EY B AH L D
HALF	HH AE F
HIPPED	HH IH P T
MEADOW	M EH D OW
PATH	P AE TH
RESIDENTIAL	R EH Z IH D EH N SH AH L
ROW	R OW
SCRUB	S K R AH B
SERVICE	S ER V AH S
SERVICE(2)	S ER V IH S
SIDEWAY	S AY D W EY
TRACK	T R AE K
TREE	T R IY
WATER	W AO T ER
WOOD	W UH D
